###############
#..#..........#
#..#..........#
#.....##..#...#
#.........#...#
#.............#
#..#..........#
#..#...#......#
#.....##..#...#
##.#......#...#
#.#.......#...#
#....#...#....#
#.....##......#
#.............#
###############